3132412213
1        2
2   222  1
3  11 1  2
2   3 3  2
2        2
3        3
1233222111